0
xxxxxxxx
x    xxx
x Sx   x
x xx x x
x    x x
x xxxx x
x      x
xxxxxx x