0
xxxxxxxxxxxxxxxxxxxxxx
x             x      x
x     x       x       
x     x       x      x
x     x       x      x
x     x       x   xxxx
x     x       x      x
x     x       x      x
x     x       x      x
xS    x              x
xxxxxxxxxxxxxxxxxxxxxx