0
xxxxxxxxxxxxxxxx xxxxxxxxxxxx
x x   x                     x
x x x x xxx xxx xxxxxxxxx   x
x   x     x   x x           x
xxx xxx xxxxx x x xxxxxxxx  x
x           x x   x x       x
x xxx xxxxx x xxxxx x x x x x
x x         x   x   x x x   x
x xxx x xxx x x xxx x x xx  x
x x           x   x   x x   x
x x x x x x x xxx xx  x x   x
x   x   x x x   x     x x   x
x  xx x     xx  x  xx x xx xx
x     x   x x             x x
x x  xxx xx x xxxx x  x xx  x
x   x x     x   x     x x   x
xxx x x xx xx x x x xxx x   x
x   x   x     x x x x   x   x
x xxx xx  x xxx x   x xxx x x
x x                       x x
x   xxx   x xx xx xx  xx    x
x   x           x x x x     x
x xxx xxx  x xx x x x xx  x x
x     x   x     x   x       x
x xxxxx x x xxx xxx x xx    x
x     xxx x   x   x x       x
xxx  xx x xxx x  xx x x  x  x
x       x x   x       x     x
x x   xxx x x xx  x x x     x
x x x     x   x   x x       x
x   x     xx   x   x  x  x xx
x x   x                     x
x x x xxx x xxx x x x x x x x
xS                          x
xxxxxxxxxxxxxxxxxxxxxxxxxxxxx